NO ./textures/Wall.xpm
SO ./textures/Wall.xpm
WE ./textures/Wall.xpm
EA ./textures/Wall.xpm

C 150,150,250
F 50,50,50

1111111111111111
1000000000000001
1000000000000001
1000000E00000001
1111111111111111
