NO ./textures/NuketownWall.xpm
EA ./textures/NuketownWall.xpm
SO ./textures/NuketownWall.xpm
WE ./textures/NuketownWall.xpm
C 173,190,209
F 166,166,166

1111111111111111111111111
1000000000110000000000001
1011000001110000110000001
1001000000000000000000001
1111111110110000011100001
10000000001100000111011111111
11110111111111011100000010001
11110111111111011101010000001
11000000110101011100000010001
10000000000000001100000010001  
10000000000000001101010010001   
11000001110101011100011110N01
11110111111101011101111110001      
11111111111111111111111111111    
