NO ./textures/OriginsNorth.xpm
SO ./textures/OriginsSouth.xpm
WE ./textures/OriginsWest.xpm
EA ./textures/OriginsEast.xpm

C 57,62,64
F 15,21,26

1111111111111111111111111
1000000000000000000000001
1011111111111111111111001
1001000000000000000001001
1011111111101111111111001
1010000000000000000001001
1010111110111111111101001
1010100000000000000101001
1010101111111111110101001
1010100000000000000101001  
1010111111101111111101001   
1000000000000000000000001
10111111000S0001111111101
1000000000000000000000001
1111111111111111111111111  
